39	40	0	0	6	6	6	6	0	0	0	0	0	0	0	0	0	0	0	0	0	0	6	6	6	6	6	6	6	6	6	6	0	0	0	0	0	0	0	0	0	6	6	6	6	6	6	6	6	6	6	0	0	0	0	0	6	0	0	0	0	0	0	0	0	0	0	0	39	40
55	56	0	0	6	6	6	6	0	0	0	2	0	0	0	0	0	0	0	0	0	0	6	6	6	6	6	6	6	6	6	6	0	0	0	0	0	0	0	0	0	6	0	6	6	0	6	6	6	6	6	0	0	0	0	0	6	130	130	130	130	130	130	0	6	0	0	0	55	56
55	56	0	0	6	6	6	6	0	0	0	0	0	0	0	0	0	0	0	0	0	0	6	0	6	6	6	6	6	6	6	6	0	0	0	0	0	0	0	0	0	6	0	6	0	0	6	6	6	6	6	0	0	0	0	0	6	6	6	6	6	6	6	66	6	0	0	6	55	56
55	56	0	0	0	0	6	6	0	0	0	0	0	0	0	0	66	6	0	0	0	0	0	0	6	0	0	0	0	6	0	0	0	0	0	0	0	0	0	0	0	0	0	0	0	0	0	0	1	6	6	0	0	2	0	0	0	0	0	0	0	0	0	0	0	0	0	0	55	56
55	56	0	0	0	0	6	6	0	0	3	0	2	0	0	0	6	6	0	2	0	0	0	0	6	0	0	0	0	6	0	0	0	0	0	2	0	39	40	0	0	0	0	0	0	2	0	0	0	0	0	0	0	0	0	0	0	0	0	0	0	0	0	0	0	0	0	0	55	56
55	56	0	0	0	0	6	6	0	0	0	0	0	0	0	0	6	6	0	0	0	0	0	0	6	0	2	2	0	6	0	0	0	0	0	0	0	55	56	0	0	0	0	0	0	0	0	0	0	0	0	0	0	0	0	0	0	0	0	0	0	0	0	0	0	2	0	0	55	56
55	56	0	0	0	0	6	6	0	0	0	0	0	0	0	0	0	0	0	0	0	0	0	0	0	0	0	0	0	6	0	0	0	0	0	0	0	55	56	0	0	0	0	0	0	0	0	0	0	0	0	0	6	6	0	0	0	0	0	0	0	0	0	0	0	0	0	0	55	56
55	56	0	0	0	0	6	6	0	0	0	0	0	0	0	0	0	0	0	0	0	0	6	0	0	0	0	0	0	0	0	0	0	0	0	0	0	55	56	0	0	0	0	0	0	0	0	0	0	0	0	0	6	6	0	0	6	0	0	0	0	0	6	0	0	0	0	0	55	56
55	56	0	0	0	0	0	0	0	0	0	0	0	0	0	0	0	0	0	0	0	0	0	0	0	0	0	0	0	0	0	0	0	6	0	0	0	55	56	0	6	6	6	6	6	6	0	0	0	0	0	0	0	0	0	0	6	0	0	0	0	0	0	0	0	0	0	0	55	56
55	56	0	0	6	0	0	0	0	0	0	39	40	0	0	0	0	0	0	0	6	0	0	0	0	0	6	6	0	0	0	0	0	0	0	0	3	55	56	0	6	6	6	6	6	6	0	0	6	6	0	0	0	0	0	0	0	6	6	0	0	0	0	0	0	0	0	0	55	56
55	56	0	0	6	0	0	0	0	0	0	55	56	0	0	0	0	0	0	0	0	0	0	0	0	6	6	6	6	0	130	0	0	0	0	0	0	55	56	0	6	6	6	6	6	6	0	0	6	6	0	6	0	0	0	0	0	1	6	0	0	0	0	0	0	6	0	0	55	56
55	56	1	0	6	130	0	0	0	0	0	55	56	0	0	0	0	0	6	0	0	0	0	0	0	0	6	6	0	0	0	0	0	0	0	0	0	55	56	0	0	0	0	0	0	0	0	0	6	6	6	0	0	130	130	0	0	0	0	6	6	0	0	0	0	0	130	0	55	56
55	56	0	0	6	0	0	130	0	0	0	55	56	0	0	0	0	0	0	0	0	0	0	0	0	0	0	0	0	0	0	0	0	0	0	0	0	55	56	0	130	0	0	0	0	0	130	0	6	0	0	0	0	0	0	0	0	0	0	6	6	0	0	0	0	0	0	0	55	56
55	56	0	0	6	0	0	0	0	0	0	55	56	0	0	0	130	0	0	0	0	0	0	0	0	0	0	0	0	0	0	0	0	0	0	0	0	55	56	0	0	0	0	0	0	0	0	0	6	0	0	0	0	0	0	0	0	0	0	6	6	0	130	0	0	0	0	0	55	56
50	50	50	66	50	50	50	50	50	50	50	50	50	50	50	50	50	50	50	50	50	50	50	50	50	50	50	50	50	50	50	50	50	50	50	50	50	50	50	50	50	50	50	66	50	50	50	50	50	66	50	50	50	50	50	50	50	50	50	50	50	50	50	50	50	50	50	50	50	50
